R  64700 2500
NO img/bluestone.xpm
WE img/purplestone.xpm
SO img/redbrick.xpm
EA img/eagle.xpm
S img/barrel.xpm
F 184   ,    113   ,    39
C 77,148,255



        111111111111 1111111111111
        100000000011 1000000000001
        101100000111 1000002000001
        100100000001 1000000000001
11111111101100000111 1000000000001
10000000001100000111 1111111111111
11110111111111011101 100010001
111101111 1111011101 110010001
11001000110101011101 100010001
1020000W000011001101 100000001
10000000000001001101 110010001
11000001110101011111 111110201
11110111 1110101 101 111010001
11111111 1111111 111 111111111