R  900 500
NO img/bluestone.xpm
WE img/purplestone.xpm
SO img/redbrick.xpm
EA img/eagle.xpm
S img/barrel.xpm
F 184,113,39
C 77,148,255


        1111111111111111111111111
        1000000000110000000000001
        1011000001110000002000001
        1001000000000000000000001
111111111011000001110000000000001
100000000011000001110111111111111
11110111111111011100000010001
11110111111111011101010010001
11001000110101011100000010001
1020000W000000001100000000001
10000000000000001101010010001
11000001110101011111011110201
11110111 1110101 101111010001
11111111 1111111 111111111111