R 900 600
NO img/bluestone.xpm
WE img/purplestone.xpm
SO img/redbrick.xpm
EA              img/eagle.xpm
S                       img/barrel.xpm
F 148,125,177
C 25,148,255

111111111111
1000000S0001
100000020001
100200000001
100000000201
111111111111