R  1400 600
NO img/bluestone.xpm
WE img/purplestone.xpm
SO img/redbrick.xpm
EA img/eagle.xpm
S img/barrel.xpm
F 184   ,    113   ,    39
C 77,148,255

        1111111111111111111111111
        1000000000111000000000001
        1011000001111000002000001
        100100000001000000000001
111111111011000001111000000000001
100000000011000001111111111111111
11111111101111111111111111111
11111111101111111111111111111
11001000N00101011101100010001
10200002000011001101 100000001
10000000000001001101 110010001
11000001110101011111 111110201
11110111 1110101 101 111010001
11111111 1111111 111 111111111