R  900 600
NO img/bluestone.xpm
WE img/purplestone.xpm
SO img/redbrick.xpm
EA              img/eagle.xpm
S                       img/barrel.xpm
F 148,125,177
C 25,148,255

11111111
10121001
11000001
12002011
1100S021
10000011
10012111
11111111