R  2000 2000
NO img/bluestone.xpm
WE img/purplestone.xpm
SO img/redbrick.xpm
EA              img/eagle.xpm
S                       img/barrel.xpm
F               184,113,39
C 77,148,255

        1111111111111111111111111
        1000000000111000000000001
        1011000001111000002000001
        1001000000010000000000001
111111111011000001111000000000001
100000000011000001111111111111111
11111111101111111111111111111
11111111101111111111111111111
11001000000101011101100010001
1020000000000001101 100000001
100000000000W001101 110010001
10000001110100001111 111110201
11110111 1110101 101 111010001
11111111 1111111 111 111111111