R 1080 720
NO pics/bluestone.xpm
WE pics/purplestone.xpm
SO pics/redbrick.xpm
EA pics/eagle.xpm
S pics/barrel.xpm
F 184,113,39
C 184,113,39



111111111111
100000000001
100200002001
100000N00001
100200002001
100000000001
111111111111