R 1540 1020
NO pics/bluestone.xpm
WE pics/purplestone.xpm
SO pics/redbrick.xpm
EA pics/eagle.xpm
S pics/barrel.xpm
F 184,113,39
C 77,148,255



11111111111
10000100001
10100000001
1N0000010001
1000100001001
10100001001111
10000000001
11111111111