R 1540 1020
NO pics/bluestone.xpm
WE pics/purplestone.xpm
SO pics/redbrick.xpm
EA pics/eagle.xpm
S pics/barrel.xpm
F 184,113,39
C 184,113,39



11111111111
10000000001
10N00002001
10002000001
10002000001
10002002001
10020000001
11111111111