R 1080 720
NO pics/bluestone.xpm
WE pics/purplestone.xpm
SO pics/redbrick.xpm
EA pics/eagle.xpm
S pics/barrel.xpm
F 184,113,39
C 184,113,39



111111111111111111
100000000000000001
100200002000002001
100000N00000000201
100200002000000001
100000000000200001
100000000000000221
100000200002000021
111111111111111111