R 1920 1080
NO pics/bluestone.xpm
WE pics/purplestone.xpm
SO pics/redbrick.xpm
EA pics/eagle.xpm
S pics/barrel.xpm
F 184,113,39
C 184,113,39



 1111111111111111111111     
 1000000000S0000111 
 11111111111111111111111 
 111111111111  
 10000000111   
 111111111111    